00000001000000000100000000100000
01010100101101110011010100101010
00000100001001001000000001001010
01011000010010000110100111011000
10000001000110100000100000000100
00101100111100010101001001100101
01000100100000010100011000001000
01000000001010010100100010001010
00111001001001010000011010100010
10010000010100101011000000100100
11000100000010100001001010010001
00010010001100010000001010010100
00011001010001000001100100100110
11000100010100110010001000000000
00000100010010010000110000000110
01000001000001000101110010110100
01000101011000001001100100010101
01110000000111001000001001010100
00000011100000111001010000010010
01101100010010000101000101111010
00100100000110100000111000011010
10010000100000001000000011000000
