00000001000000000100000000100000
01010100101101010011010100101010
00000100000001000000000001001010
01011010010000000100100111011000
10000000000100100000100000000100
00101100110100010101001001100101
00000100100000010100011000001000
01000000001010000100000010001010
00110001001001010000011010100010
10010000010100001011000000100100
11000100000010100001001010010001
00010010001100010000001010010100
00011001000001000001100100100110
11000100010100110010001000000000
00000100010010010000110000000110
01000001000001000100000010110100
01000101011000001001100100010101
01010000000011001000001001010100
00000011000000011001010000010010
01101000010010000101000101111010
00100100000110100000011000011010
10010000100000001000000011000000
