00000010000000010010000001100000
01100000111101000000010100001100
00010100000001100001000010000000
01000000000110000010000001000001
00000000000010100100000000000011
10000000000000100000000000000011
00000000000101001110000100001001
01100000100010010000000010000100
00101100000000000100111000000000
10100000000001010010000000000000
10101000000000000000000000000000
00100110000010000100000000000010
01000000000000000000000000011000
00011010110010000010000000001010
11000010000000000000000000000010
00010110000000000000000100000100
01100110000001000010000000000000
00001000000001000010000010001010
10110010000000101000000000111010
00100010101010000010000110100010
01100010101001001010000000101100
00001000000100000010000100000001
