00010000110000000001000000000010
01000110000100100100010001001000
00110100000000000011010010010001
10100001010001001000001000110100
00000010010000011101100001000010
01010000111001100000010010011010
00010100010010000010010000100010
11000011000000010100000110101000
00000000101101100000100000000110
00010110000100001010010010010000
01010000010001010001000000100100
10011011001000000101010110011000
00000000001000101100010000001010
00000010010001000001100110100010
00101100100101010000001000001100
00101000001000000010000010100100
00100010011010110100111000100000
10001011000000010100000001000010
00101000010011000100010000010100
10100011001000101000001110100000
00011000101010001010001000001010
00000010000000100000100010100000
