00000001000100100010000100000100
01000100000000001000000001110000
00100000000000111101001110011100
01001001000101001100101000100010
00001001011001010001101010100010
10010010010010000010001000001010
00110100110100111010101010010010
01000101100101100010100010100100
01011000001001000000010100101001
01001010000010001001000000000011
01101000100100100010000010010001
00100100010000001100000000000000
10101001011110001001001000100010
00101011000001010010001101001000
01100000100000000100100001000010
00000110100000111101000010011010
11001010010101000001010000001010
00101000000100011110000100000010
00101010111000100010001001010100
00001000000010001010000010010101
01110010011001101000011010110100
00000000010000000001001000000000
