00100000010010000010001100010000
00000111001000110010100001010110
01010000000010010000100110010100
01001010000011010001000000110010
00001010010000001001010001000010
00000001000001100100010101101000
01011100110001000011010100001010
01000100000110000001000000110010
00100001010000000100001111000000
10001010000110101000101000010010
00000010110000000001000110001010
01101000100110110100010100101000
00001010001000010000000001100000
01010000100011000010001000000001
00010100110000100001100111100100
01000000000000000100010000011110
00010000101001010011001000000100
00100010001000010000101100110101
01001000000101011100100001000000
01000011010000010000010110011010
00010110001011000000100000110000
00000000100000001000001010000100
