00100000010010000010001100010000
00000111001000110010100000010110
01010000000010000000100110000100
01001010000011010001000000110000
00001010010000001001010000000010
00000001000001100000000101101000
01011100110000000011010100001010
01000100000110000001000000100010
00000001010000000100001110000000
10001010000110101000100000010010
00000010110000000001000110001010
01101000100110110100010100101000
00001010001000010000000001100000
01000000100011000010001000000001
00010100110000100001100101100100
01000000000000000100000000010110
00010000101001010010001000000000
00000010001000000000101100110101
01001000000101010100100000000000
01000011010000010000010110011010
00010110001011000010000000110000
00000000100000001000001010000100
