00001000100100010000110001110000
01000000000001000110000100100110
01010111111011010001110010101000
01100100000000010100000100100000
00000001010101000001001001100100
01000001000001100100000010010010
01000000101010000010010100000110
01000110001001011000000100011000
01100010001000000011011001100010
00000001000000010100000010001100
01100100111000000001000110111001
00010100000110001100000100100011
01010000110000100010001001001001
01000010010010101000010010010000
10010011000000101111100000110010
00100000011001100000001001000010
01000110110101001000110100000100
00010001000001000101000010000101
00000101101110000000011000001000
01101000101000000011000100101010
00001011001011000000110101000010
00000000010000100010000100010100
