00001001000000111000000001001000
01000000010010010011101100000010
01100010110011100100001101001001
00000010001000101101100000000100
11010010101010001000011010000010
00011010000011110010000000011010
01100010000100010100011100001100
00001101000001010000000000100001
01100001010100001001111110001000
00001100010100000100000000101010
11100101000001010000001011001010
00010110010001001110000000011000
01010001100000101000010110100010
01001100101010000011000100100010
00100010001010101000000001000000
10110011001000000010110010000010
10001000010001000100000000101000
00000101000100101000000000001001
01000110101000000010001111100101
01010000000011110100100000010100
00010011111100000010011011010110
00001000000001011000000000000000
