00000010000010000010000100100000
00001001101000001001010001001010
00100000000100110010011101010000
01101011001000010100100011000010
00001010110011010000101000100100
01000000000101001000000110001001
10000010001100000000010001110001
00100001101001101000111000000001
01100000001010001110010010110011
00010100110001100001000010000001
01000010000100011000010011000100
01010010100011010001000100010010
01000000011001000100000101101010
01000010001101010011001001000010
01100010100101000001011010010110
00010010000100100000010010100100
01010101000010010100000100001101
10010001001010010001111000100001
00111100000010110010000010001010
01000001000110001100101001111000
01010101101001101001000100000110
00000100000000000000010000010000
