00000100000000000000000001100000
00110101101110000010110100010110
00110000100001000010000101010100
10001000101001000000000101010101
00000100010000010010100010010100
01010101000110001011101010110010
00000001001100101000001000000010
01011011010001001001001011010110
00001000011011000010010010001000
10000101001000110100000100000010
01110101000010001001111000000010
00000101101001100100000010000100
01111100010000000011001110111101
01000011000001001000100000100000
00101000011011100101001110100010
00001101000001110100010000100000
01000001011000100101000111100100
00110110010010100000111000010001
10000111010110000010000010000100
10110010010101100110110100100101
00001100000000000000001100001000
00100001001011000101100000100010
