00000001100000001001100000000000
01110100001011000000001110110010
00100011010000011000010010000100
00011110010111100111000101111110
01000001001000010100000000000100
00111100100101000001101010010101
10100101010101111000111001110100
10001101010110001000000100000110
00100001010000101011110110101000
01110110001111100100010001100000
00100000100000010001001101000001
10100010101110100011100100100100
10010100011010000100010110010010
01001000000011010000010001010110
00001010101000101110100110001000
01001100000100000010010000110010
00100011010000011011001101000100
01011000100100011001011101010000
00001110110101100101001001001001
10100010000001110000100011010100
00011001101010000110011100010110
00000000000010001111000001100000
