000101010000010100001100
010100000100100101000001
110010101010001000011010
001010111000101010001000
101000000111001000100110
001010110000010010100100
010010011110111000001001
010101000010010010000100
010000001010110111110000
001111110010000010001100
000000010010111010100000
011010100100001100110111
011001001001110010001000
000100100010000010100010
000100110000001001011000
100100000001000100000000