00010000011010001000010000000000
01000011000010100010000110110101
10101100110100010100101010001000
00100000000001001001101001000100
01011010101110010010000100010001
00000010110000101000110001100100
00000100010101000111001111001010
10001000000100001100010000101010
00110010110011001001100110100010
01000110001000100000001000011100
01011000100110010100100001000100
01110011010101000110110010010000
00001001010000110010011001011111
11100101001110001001000100100000
00010001100011101100110111001110
01101110001000100010010000100010
01000000101111111001011110001010
01010101010000100000100011100100
00010100000110101000001000010101
01110011111010101001100111001000
01000100001010000110101000101010
00010001100001010000001010000010