000010000001110000101000
011010110100100101000010
101010001010101110011001
001010101000100100110100
011010100101010101100110
000010110100000101001000
011110010101010100010010
010000100010001010100110
011101001100110000101000
000010010001000111001010
101011001110010100010100
011000101000101001100010
000101100011001010001000
101100011100010010100101
001011000001000101010110
100000010100101000000000