00000001000010000100000000000000
01001100011000110000101110101010
01010011100011001110000001101010
01000000011001011010100001001010
01010001000101000010001000011010
00100011100001010001000110100010
10101100001110010100100000000110
10101000010000100001001100000000
00101011000011001100100011100110
01001000010000101000011010010010
01010111010110010011001001001010
00000000010100000100100100000001
11101010100100001001010011000000
00000010001001110100010100100000
01011000010100100100100001110100
00000111100010000000010100100101
10010100011010100011010111101000
10100001000001100101000000000110
00100000010100100001001101111000
01100101100010111011010010000010
00010000101000000100000100011110
01000110001001010000010001000000
