000000010000001100010001
001010100000100001001000
101001001010000110101001
100000011000111100100100
001100100011000001010010
100101101100101101011010
010000001001000110001000
000100110100010000100110
011001000011001111001110
010011011000101000000100
000100010110101010100010
111010010010100010011010
000010000100111111001000
101010010010000010000111
001101100000111010110000
100000001100001000001010