000000010000101000001000
010010100110000110100010
000000101000010000010100
010001001000000100100101
000101010001101000001000
010000010100000011110110
100100100100111010000000
001001101101000100111010
010100001001010001100010
010010100010011111001100
011001011000100000011001
000100001111001010000010
010110100000010010011100
010010011101100100100010
010100100110001101000010
000001110000100000000000