00100000011000000100010001000000
00001101100011010101000100011101
01011000001100010100110110100000
01001011111001100000100001001110
01100010000010001011001010010010
00011100101101001000010010100110
10000010010001100110001000010100
10101001010000010001101111010001
00100101010010010100100010001100
01110100001000110101010010101000
01100010010011000100000011001000
00001100000100011111011000001011
01010001101001010100000111000010
00000110100010010101100000001000
01001000101100100100101110101001
10010011101001001000101010100100
00110100001010010000100010001110
01000000101001010110111001110000
01101110011100010100000010000010
00100001001000100011110010111010
10000000100010101100000110101010
11000000011000100001010000100000
