00000100010000000010000011000000
01110101110101011000001000101110
10010100000010011101010110010000
10110011101000101000000011000110
00001000011100100010111001110010
01100001001101001010100100011000
00011010100001001010101111000100
01000000011110110010100100010110
00101110100000000100010001010000
10101000100010110101000100001111
01001011100100100101001010100000
00000100001001001100100000011100
10100001110010011010011100000100
00010110001001000001000011101001
01010001010100111100110000101011
00110100000101000101000110010001
01000101101001010100101001000100
00011010001010010010000011111110
01100000101000100101101001000100
01001010110100001000010010010010
01010100000010011011011100001010
00010001101001000001000001000000