000100100011100011000100
010010001001001000010110
101001011101010010100010
000100101000011100010100
011010100010100011010101
010010010100101001010100
000101001001100101010110
011000010010001100010010
010011100100110011001010
000100001101010100110010
011001011001000001000100
000100110010011011011001
110101000100111100001100
000011011010011001100010
011100010001000010011010
000001100100010111000000