000010000000100000000000
011001010110001011110001
100100100001010010000100
001110101001001001010001
100110100101000101101100
000000001001010100000010
011001110100110011101000
100010000010100100000100
100000011010001001001001
001000100010010010000100
010010011001000101001001
001001000010111001011100
101100101000000101001010
000010000101101000100010
101000111000110010000000
000100000010000100110000