000100100000001000000010
010110001011000111101010
010001001010010000001010
100000110000101111110010
001110001011000000010100
010001101000101111010001
100101001101001001001100
001000100101010011100010
010010010101011001001100
010111010100001100010101
001010100100100001000100
100000101000011110000001
001110100101000010100010
100010010101001010001100
001001100000110011000010
011100001010000100001000