00010000011000100011100001000000
01000110000010000001001010010100
00111001001101101100010000010001
10000100000000010010101100100100
01110101100101001000100010101000
00010100010000101010001010001010
01000101000100101001001001010000
10011000111001100100010010100110
00110011000011010101100110001100
00001010000110010010001100110001
01100100100100100100110001000110
00101001010001001010110011011000
10001011001010010010010010010010
00100100010011000101011000100100
01000001001000101001001000101001
01011110101110000011000100001100
01010000100001010111010010010010
00010101111100110010001000100110
11100100100010100100101011001000
00101010010110010010101010011010
01101001000001011110101010100010
00000010010100000000100010001000
