000001001010010100100010
011100100001000010001000
100110101100011001101110
110000101110110100100001
110110100101000010010100
100101001001011001000010
001000010011001010101010
010010101000101000010010
010100001101000111001010
001001100001011000100100
101010111101010010110001
001010000001010110011100
010001110111010001000110
001110001000010100111000
101000100011100010001011
000010010100001001100000