000001100001000010000101
011100010100010100110000
100010000101001001010110
001101010010100010010100
100000011010010001000010
101011101000101100111100
001010000010000001000101
100100111010011011010001
010101000011010000011100
010001011001011011100010
010010011101000100010000
001001001000110001000101
101010100101000100101001
001010010100011010101010
010001000111110000110000
000100010000000110000110