00101000010000000001111101000010
01000011010111101100111001011000
01000100010100101110010011010010
00100000100101100111000100010100
10011001100000010000101001100101
01001100001100001000010000001100
00100011100001100111000001101001
01000000010011010000111110001010
00000001000100001010000100110000
10001110110001010011100001000101
00100100001100000010001010101000
01110001101001111010101000010010
00001100101010001001001111000100
00000101000010100010010001001001
01010101011010011110100101100100
00010100110010100001101000010110
01100010000100101000001011010010
01001001101001001010110000001001
01011000100000010001000100100100
00110000110011101011010010010010
10100110010110000000001011011010
00001111010000100010001000000000
