000100000100010000010000
010000101001011001001010
101000100010000010100010
100010011100101000010000
001100100001101011000000
100000010110001000100110
011110010110111110110001
000011000000001000001100
011000010011000111110010
000011000101010000001000
100000111000010001100010
001110101111000010011000
010000000001111000011110
000110100100000100001000
101010100111010010100101
000000001000001000001000