00011000000001000100010000000010
01000101010100010011001011011010
11110010010111101010100001010010
01000100101000101000101010010100
00011110001010100110100100100110
01100000100010100010110101001010
00001001010100100010001000101000
01010010001101010110100010101010
00100100110001000000010000100010
10010101000110111111000011101010
00100101011100000001110100011000
00010001010001110100000001011001
01001010010110001111100011000101
01010001000000100100010110010100
00010110101101010001100001010110
01101000010010001100101101110010
01000011001000101110100100001001
00011100100101100100010011100100
10000001110100010101001010010101
01001100100011100001110001010000
00010000001000011110001101001101
01000100011101000000100000100000