00100100100000010010000000101010
00110001001111001000101010000000
00100100010001100110010011100010
10101001100100011000100100010000
00100101100001001010010001010101
01101100000110100001001110010010
01000010111000101100101000101010
01010000000010010010000011000000
01111001010011011011001010100110
00010010110100001000111000001100
11010100000101010010000101101001
01001101111110000101010000001100
00101000000100100000000010100010
10101010101001000101010010101010
10001010001010010100100100011010
00111001011000100110010000100010
01000010010101010000100100101010
00110111000010001110010101000100
10000010011001100001100101011001
01001000011100101010001011010010
01011010001000001010000000010100
00000010100001010000000110000001
